####################
# 2#####  M     KG##
#  ##### ###########
# ######   ### R ###
#                1 #
########D###########
#                #G#
###   ######  #  # #
#R         ####  #D#
#####  ####        #
#   M   #      #####
# M M   ####   M   #
#         #        #
#  ## #          ###
#  #K #####   #    #
#  #  #       #    #
#     # M  ####    #
# #  ### ####R#    #
#      # #         #
####################